JJJJJJJJJJJJJJJJJJJJJJJJJJJJJJJJJJJJJJJJ
JJJJJJJJJJJJJJJJJJJJJJJJJJJJJJJJJJJJJJJJ
JJDRRRRRRRRRRRRRRRRRRRRRRRRRRRRRRRRRREJJ
JJK0000000000000000000000000000000000IJJ
JJK0000000000000000000000000000000000IJJ
JJK0000000000000000000000000000000000IJJ
JJK0000000000000000000000000000000000IJJ
JJK0000000000000000000000000000000000IJJ
JJK0000000000000000000000000000000000IJJ
JJK0000000000000000000000000000000000IJJ
JJK0000000000000000000000000000000000IJJ
JJK0000000000000000000000000000000000IJJ
JJK0000000000000000000000000000000000IJJ
JJK0000000000000000000000000000000000IJJ
JJK0000000000000000000000000000000000IJJ
JJK0000000000000000000000000000000000IJJ
JJK0000000000000000000000000000000000IJJ
JJK0000000000000000000000000000000000IJJ
JJK0000000000000000000000000000000000IJJ
JJLBBBBBBBBBBBBBBBBBBBBBBBBBBBBBBBBBBMJJ
JJJJJJJJJJJJJJJJJJJJJJJJJJJJJJJJJJJJJJJJ
JJJJJJJJJJJJJJJJJJJJJJJJJJJJJJJJJJJJJJJJ