JJJJJJJJJJJJJJJJJJJJJJJJJJJJJJJJJJJJJJJJ
JJJJJJJJJJJJJJJJJJJJJJJJJJJJJJJJJJJJJJJJ
JJDRRRRRRRRRRRRRRRRRRRRRRRRRRRRRRRRRREJJ
JJK7777777777777777777777777777777777IJJ
JJK8888888888888888888888888888888888IJJ
JJK----------------------------------IJJ
JJLBBBBBBBBBBBBBBBBBBBBBBBBBBBBBBBBBBMJJ
JJDRRRRRRRRRRRRRRRRRRRRRRRRRRRRRRRRRREJJ
JJK0000000000000000000000000000000000IJJ
JJK0000000000000000000000000000000000IJJ
JJK0000000000000000000000000000000000IJJ
JJK0000000000000000000000000000000000IJJ
JJK0000000000000000000000000000000000IJJ
JJK0000000000000000000000000000000000IJJ
JJK0000000000000000000000000000000000IJJ
JJK0000000000000000000000000000000000IJJ
JJK0000000000000000000000000000000000IJJ
JJK0000000000000000000000000000000000IJJ
JJK0000000000000000000000000000000000IJJ
JJLBBBBBBBBBBBBBBBBBBBBBBBBBBBBBBBBBBMJJ
JJJJJJJJJJJJJJJJJJJJJJJJJJJJJJJJJJJJJJJJ
JJJJJJJJJJJJJJJJJJJJJJJJJJJJJJJJJJJJJJJJ