JJJJJJJJJJJJJJJJJJJJJJJJJJJJJJJJJJJJJJJJ
JJJJJJJJJJJJJJJJJJJJJJJJJJJJJJJJJJJJJJJJ
JJDRRRRRRRRRRRRRRRRRRRRRRRRRRRRRRRRRREJJ
JJK7777777777777777777777777777777777IJJ
JJK8888888888888888888888888888888888IJJ
JJK----------------------------------IJJ
JJLBBBBBBBBBBBBBBBBBBBBBBBBBBBBBBBBBBMJJ
JJDRRRRRRRRRRRRRRRRRRRRRRRRRRRRRRRRRREJJ
JJK0000000000000000000000000000000000IJJ
JJK0000000000000000000000000000000000IJJ
JJK0000000000000000000000000000000000IJJ
JJK0000000000000000000000000000000000IJJ
JJK0000000000000000000000000000000000IJJ
JJK0000000000000000000000000000000000IJJ
JJK000000000000000000000000000ABC0000IJJ
JJK000000000000000000000ABC000IJK0000IJJ
JJK000000000000000000000IJK000QRS0000IJJ
JJK000000000000000000000QRS0000000000IJJ
JJK000000ABC0000000000000000000000000IJJ
JJLBBBBBBMJLBBBBBBBBBBBBBBBBBBBBBBBBBMJJ
JJJJJJJJJJJJJJJJJJJJJJJJJJJJJJJJJJJJJJJJ
JJJJJJJJJJJJJJJJJJJJJJJJJJJJJJJJJJJJJJJJ