gfx/tileset.png
JJJJJJJJJJJJJJJJJJJJJJJJJJJJJJJJJJJJJJJJJJJJJJJJJJJJJJJJJJJJJJJJJJJJJJJJJJJJJJJJJJJJJJJJJJJJJJJJJJJJJJJJJJJJ
JJJJJJJJJJJJJJJJJJJJJJJJJJJJJJJJJJJJJJJJJJJJJJJJJJJJJJJJJJJJJJJJJJJJJJJJJJJJJJJJJJJJJJJJJJJJJJJJJJJJJJJJJJJJ
JJDRRRRRRRRRRRRRRRRRRRRRRRRRRRRRRRRRRRRRRRRRRRRRRRRRRRRRRRRRRRRRRRRRRRRRRRRRRRRRRRRRRRRRRRRRRRRRRRRRRRRRREJJ
JJK777777777777777777777777777777777777777777777777777777777777777777777777777777777777777777777777777777IJJ
JJK888888888888888888888888888888888888888888888888888888888888888888888888888888888888888888888888888888IJJ
JJK------------------------------------------------------------------------------------------------------IJJ
JJLBBBBBBBBBBBBBBBBBBBBBBBBBBBBBBBBBBBBBBBBBBBB0000000BBBBBBBBBBBBBBBBBBBBBBBBBBBBBBBBBBBBBBBBBBBBBBBBBBBMJJ
JJDRRRRRRRRRRRRRRRRRRRRRRRRRRRRRRRRRRRRRRRRRRRR0000000RRRRRRRRRRRRRRRRRRRRRRRRRRRRRRRRRRRRRRRRRRRRRRRRRRREJJ
JJK000000000000000000000000000000000000000000000000000000000000000000000000000000000000000000000000000000IJJ
JJK000000000000000000000000000000000000000000000000000000000000000000000000000000000000000000000000000000IJJ
JJK000000000000000000000000000000000000000000000000000000000000000000000000000000000000000000000000000000IJJ
JJK000000000000000000000000000000000000000000000ABBBC0000000000000000000000000000000000000000000000000000IJJ
JJK000000000000000000000000000000000000000000000QRRRS0000000000000000000000000000000000000000000000000000IJJ
JJK000000000000000000000000000000000000000000000000000000000000000000000000000000000000000000000000000000IJJ
JJK00000000000000000000000000000000000000000000000000000000000000000000000000000000000000000000000ABC0000IJJ
JJK00000000000000000000000000000000000000000000000000000000000000000000000000000000000000000ABC000IJK0000IJJ
JJK00000000000000000000000000000000000000000000000000000000000000000000000000000000000000000IJK000QRS0000IJJ
JJK00000000000000000000000000000000000000000000000000000000000000000000000000000000000ABC000QRS0000000000IJJ
JJK000000ABC00000000000000000000000000000000000000000000000000000000000000000000000000IJK0000000000000000IJJ
JJLBBBBBBMJLBBBBBBBBBBBBBBBBBBBBBBBBBBBBBC00000000000ABBBBBBBBBBBBBBBBBBBBBBBBBBBBBBBBMJLBBBBBBBBBBBBBBBBMJJ
JJJJJJJJJJJJJJJJJJJJJJJJJJJJJJJJJJJJJJJJJK00000000000IJJJJJJJJJJJJJJJJJJJJJJJJJJJJJJJJJJJJJJJJJJJJJJJJJJJJJJ
JJJJJJJJJJJJJJJJJJJJJJJJJJJJJJJJJJJJJJJJJK55555555555IJJJJJJJJJJJJJJJJJJJJJJJJJJJJJJJJJJJJJJJJJJJJJJJJJJJJJJ
